10
15
15
xxxxxxxxxxxxxxx
x.............x
x.xxx.x.xxxxx.x
x.x.d.x.x.d.x.x
x.x.x.x.x.x.x.x
x...x.....x...x
x.x...x.x...x.x
..xxxxx.xxxxx.x
x.x...x.x...x.x
x...x.....x...x
x.x.x.x.x.x.x.x
x.x.d.x.x.d.x.x
x.xxxxx.x.xxx.x
x.............x
xxxxxxxxxxxxxxx
